32 24
EEEEEEEEEEEEEEEEEEEEEEEEEEEEEEEE
EEEEEEEEEEEEEEEEEEEEEEEEEEEEEEEE
EEEEEEEEEEEEWWWWWWEEEEEEEEEEEEEE
EEEEEEEEEEEEWFBFFWEEEEEEEEEEEEEE
EEEEEEEEEEEEWFWWFWEEEEEEEEEEEEEE
EEEEEEEEEEEEWFWWFWEEEEEEEEEEEEEE
EEEEEEEEEEEEWFFFFWEEEEEEEEEEEEEE
EEEEEEEEEEEEWWWFWWEEEEEEEEEEEEEE
EEEEEEEEEEEEEEWFWEEEEEEEEEEEEEEE
EEEEEEEEEEEEEEWFWEEEEEEEEEEEEEEE
EEEEEEEEEEEEEEWWWEEEEEEEEEEEEEEE
EEEEEEEEEEEEEEEEEEEEEEEEEEEEEEEE
EEEEEEEEEEEEEEEEEEEEEEEEEEEEEEEE
EEEEEEEEEEEEEEEEEEEEEEEEEEEEEEEE
EEEEEEEEEEEEEEEEEEEEEEEEEEEEEEEE
EEEEEEEEEEEEEEEEEEEEEEEEEEEEEEEE
EEEEEEEEEEEEEEEEEEEEEEEEEEEEEEEE
EEEEEEEEEEEEEEEEEEEEEEEEEEEEEEEE
EEEEEEEEEEEEEEEEEEEEEEEEEEEEEEEE
EEEEEEEEEEEEEEEEEEEEEEEEEEEEEEEE
EEEEEEEEEEEEEEEEEEEEEEEEEEEEEEEE
EEEEEEEEEEEEEEEEEEEEEEEEEEEEEEEE
EEEEEEEEEEEEEEEEEEEEEEEEEEEEEEEE
EEEEEEEEEEEEEEEEEEEEEEEEEEEEEEEE