40 30
WWWWWWWWWWWWWWWWWWWWWWWWWWWWWWWWWWWWWWWW
WFFFFFFFFFFFFFFFFFFFFFFFFFPFFFFFFFFFFFFW
WFWWFWFWFWFWFWFWFWFWFWFWFWFWFWFWFWWFWWFW
WFWWFWFWFWFWFWFWFWFWFWFWFWFWFWFWFWWFWWFW
WFWWFWFWFWFWFWFWFWFWFWFWFWFWFWFWFWWFWWFW
WFWWFWFWFWFWFWFWFWFWFWFWFWFWFWFWFWWFWWFW
WFWWFWFWFWFWFWFWFWFWFWFWFWFWFWFWFWWFWWFW
WFWWFWFWFWFWFWFWFWFWFWFWFWFWFWFWFWWFWWFW
WFWWFWFWFWFWFWFWFWFWFWFWFWFWFWFWFWWFWWFW
WFWWFWFWFWFWFWFWFWFWFWFWFWFWFWFWFWWFWWFW
WFWWFWFWFWFWFWFWFWFWFWFWFWFWFWFWFWWFWWFW
WFWWFWFWFWFWFWFWFWFWFWFWFWFWFWFWFWWFWWFW
WFWWFWFWFWFWFWFWFWFWFWFWFWFWFWFWFWWFWWFW
WFWWFWFWFWFWFWFWFWFWFWFWFWFWFWFWFWWFWWFW
WFWWFWFWFWFWFWFWFWFWFWFWFWFWFWFWFWWFWWFW
WFWWFWFWFWFWFWFWFWFWFWFWFWFWFWFWFWWFWWFW
WAWWFWFWFWFWFWFWFWFWFWFWFWFWFWFWFWWFWWBW
WFWWFWFWFWFWFWFWFWFWFWFWFWFWFWFWFWWFWWFW
WFWWFWFWFWFWFWFWFWFWFWFWFWFWFWFWFWWFWWFW
WFWWFWFWFWFWFWFWFWFWFWFWFWFWFWFWFWWFWWFW
WFWWFWFWFWFWFWFWFWFWFWFWFWFWFWFWFWWFWWFW
WFWWFWFWFWFWFWFWFWFWFWFWFWFWFWFWFWWFWWFW
WFWWFWFWFWFWFWFWFWFWFWFWFWFWFWFWFWWFWWFW
WFWWFWFWFWFWFWFWFWFWFWFWFWFWFWFWFWWFWWFW
WFWWFWFWFWFWFWFWFWFWFWFWFWFWFWFWFWWFWWFW
WFWWFWFWFWFWFWFWFWFWFWFWFWFWFWFWFWWFWWFW
WFWWFWFWFWFWFWFWFWFWFWFWFWFWFWFWFWWFWWRW
WFWWFWFWFWFWFWFWFWFWFWFWFWFWFWFWFWWFWWFW
WFLFFFFFFFFFFFFFFFFFFFFFFFFFFVFFFFFFFFFW
WWWWWWWWWWWWWWWWWWWWWWWWWWWWWWWWWWWWWWWW
