40 30
WWWWWWWWWWWWWWWWWWWWWWWWWWWWWWWWWWWWWWWW
W.FFFFFFFFFFFFFFFFFFFFFFFFFFFFFFFFFFFF.W
WFWBWWWWWWWWWWWWWWWFFWWWWWWWWWWWWWWWBWFW
WFWFFFFFFFFFFFFFFFFFFFFFFFFFFFFFFFFFFWFW
WFWFWWWWWWWWWWWWWWWWWWWWWWWWWWWWWWWWFWFW
WFWFBFFFFFFFFFFFFFFFFFFFFFFFFFFFFFFBFWFW
WFWFWFWFWWWWWWWWWWWWWWWWWWWWWWWWFWFWFWFW
WFWFWFWFWFFFFFFFFFFFFFFFFFFFFFFWFWFWFWFW
WFWFWFWFWFWFWWWWWWFWWFWWWWWWFWFWFWFWFWFW
WFWFWFWFWFWFWFFFFFBWWBFFFFFWFWFWFWFWFWFW
WFWFWFWFWFWFWFWWWWWWWWWWWWFWFWFWFWFWFWFW
WFWFWFWFWFWFWFWFFFFFFFFFFWFWFWFWFWFWFWFW
WFWFWFWFWFWFWFWFWWWFFWWWFWFWFWFWFWFWFWFW
WFWFWBWFWFWBWFWFW.FFFF.WFWFWBWFWFWBWFWFW
WFWFWWWFWFWWWFFFWFBFFBFWFFFWWWFWFWWWFWFW
WFWFWWWFWFWWWFFFWFBFFBFWFFFWWWFWFWWWFWFW
WFWFWBWFWFWBWFWFW.FFFF.WFWFWBWFWFWBWFWFW
WFWFWFWFWFWFWFWFWWWFFWWWFWFWFWFWFWFWFWFW
WFWFWFWFWFWFWFWFFFFFFFFFFWFWFWFWFWFWFWFW
WFWFWFWFWFWFWFWWWWWWWWWWWWFWFWFWFWFWFWFW
WFWFWFWFWFWFFFFFFFBWWBFFFFFFFWFWFWFWFWFW
WFWFWFWFWFWWWWWWWWFWWFWWWWWWWWFWFWFWFWFW
WFWFWFWFFFFFFFFFFFFFFFFFFFFFFFFFFWFWFWFW
WFWFWFWWWWWWWWWWWWWWWWWWWWWWWWWWWWFWFWFW
WFWFBFFFFFFFFFFFFFFFFFFFFFFFFFFFFFFBFWFW
WFWFWWWWWWWWWWWWWWWWWWWWWWWWWWWWWWWWFWFW
WFWFFFFFFFFFFFFFFFFFFFFFFFFFFFFFFFFFFWFW
WFWBWWWWWWWWWWWWWWWFFWWWWWWWWWWWWWWWBWFW
W.FFFFFFFFFFFFFFFFFFFFFFFFFFFFFFFFFFFF.W
WWWWWWWWWWWWWWWWWWWWWWWWWWWWWWWWWWWWWWWW