32 24
EEEEWWWWWWWWWWWWWWWWWWWWWWWWEEEE
EEEEWFFFFFFFFFFWWFFFFFFFFFFWEEEE
EEEEWFWWWFWWWWFWWFWWWWFWWWFWEEEE
EEEEWBWEWFWEEWFWWFWEEWFWEWBWEEEE
EEEEWFWWWFWWWWFWWFWWWWFWWWFWEEEE
EEEEWFFFFFFFFFFFFFFFFFFFFFFWEEEE
EEEEWFWWWFWWFWWWWWWFWWFWWWFWEEEE
EEEEWFWWWFWWFWWWWWWFWWFWWWFWEEEE
EEEEWFFFFFWWFFFWWFFFWWFFFFFWEEEE
EEEEWWWWWFWWWWFWWFWWWWFWWWWWEEEE
EEEEEEEEWFWWWWFWWEEEEEEEEEEWEEEE
EEEEEEEEWEEEEEEEEEEEEEEEEEEWEEEE
EEEEWWWWWEEEEEEEEEEEEEEEEEEWEEEE
EEEEWEEEEEEEEEEEEEEEEEEEEEEWEEEE
EEEEWEEEEEEEEEEEEEEEEEEEEEEWEEEE
EEEEWEEEEEEEEEEEEEEEEEEEEEEWEEEE
EEEEWEEEEEEEEEEEEEEEEEEEEEEWEEEE
EEEEWEEEEEEEEEEEEEEEEEEEEEEWEEEE
EEEEWEEEEEEEEEEEEEEEEEEEEEEWEEEE
EEEEWEEEEEEEEEEEEEEEEEEEEEEWEEEE
EEEEWEEEEEEEEEEEEEEEEEEEEEEWEEEE
EEEEWEEEEEEEEEEEEEEEEEEEEEEWEEEE
EEEEWEEEEEEEEEEEEEEEEEEEEEEWEEEE
EEEEWWWWWWWWWWWWWWWWWWWWWWWWEEEE