32 24
WWWWWWWWWWWWWWWWWWWWWWWWWWWWWWWW
WFFFFFFFFFFFFFFFFFFFFFFFFFFFFFFW
WFWWWWWWWWWWWWWWWFWWWWWWWWWWWWFW
WFWEEEEEEEEEEEEEWFWEEEEEEEEEEWFW
WFWEEEEEEEEEEEEEWFWEEEEEEEEEEWFW
WFWEEEEEEEEEEEEEWFWEEEEEEEEEEWFW
WFWEEEEEEEEEEEEEWFWEEEEEEEEEEWFW
WFWEEEEEEEEEEEEEWFWEEEEEEEEEEWFW
WFWEEEEEEEEEEEEEWFWEEEEEEEEEEWFW
WFWWWWWWWWWWWWWWWFWWWWWWWWWWWWFW
WAFFFFFFFFFFFFFFFPFFFFFFFFFFFFFW
WFWWWWWWWWWWWWWWWFWWWWWWWWWWWWFW
WFWEEEEEEEEEEEEEWFWEEEEEEEEEEWFW
WFWEEEEEEEEEEEEEWFWEEEEEEEEEEWFW
WFWWWWWWWWWWWWWWWFWWWWWWWWWWWWFW
WRFFFFFFFFFFFFFFFVFFFFFFFFFFFFLW
WFWWWWWWWWWWWWWWWFWWWWWWWWWWWWFW
WFWEEEEEEEEEEEEEWFWEEEEEEEEEEWFW
WFWEEEEEEEEEEEEEWFWEEEEEEEEEEWFW
WFWEEEEEEEEEEEEEWFWEEEEEEEEEEWFW
WFWEEEEEEEEEEEEEWFWEEEEEEEEEEWFW
WFWWWWWWWWWWWWWWWFWWWWWWWWWWWWFW
WFFFFFFFFFFFFFFFFFFFFFFFFFFFFFFW
WWWWWWWWWWWWWWWWWWWWWWWWWWWWWWWW