32 24
WWWWWWWWWWWWWWWWWWWWWWWWWWWWWWWW
WFFFFFFFFFFFFFFWWFFFFFFFFFFFFFFW
WFWWWWFWWWWWWWFWWFWWWWWWWFWWWWFW
WFWWWWFWWWWWWWFFFFWWWWWWWFWWWWFW
W                              W
W                              W
W                              W
W                              W
W                              W
W                              W
W                              W
W                              W
W                              W
W                              W
W                              W
W                              W
W                              W
W                              W
W                              W
W                              W
W                              W
W                              W
W                              W
WWWWWWWWWWWWWWWWWWWWWWWWWWWWWWWW
